00000000000000000000
0000000000XXXXXX0000
00XXX00000X1111XX000
00XPX000XXX11111X000
00X1XXXXX1111111XX00
00X1111XX1XX11111X00
00XXX1XXXDXX11111X00
0000X111111X1111XX00
0000X111111XXXXDXX00
0000X111111XXX111XX0
0000XXDXX1XXX11111X0
00000X1XXXX1X11111X0
00000X111111X1X1X1X0
00000X111111X11X11X0
00000X111111X11111X0
000000X111111X1X1X00
0000000XXXXXDXXXXX00
00000000000X1X000000
0000000000X111X00000
000000000X11111X0000
00000000X1111111X000
000000000X11111X0000
0000000000X111X00000
00000000000X1X000000
00000000000XEX000000
00000000000XXX000000
00000000000000000000