0000000000
00P1111000
0001101100
0011111100
0011001100
0011001100
0011111100
0000011000
0000000000
0000000000