000000000000000000000000000000
000000000000000000000000000000
0000XXXX00000000XXXXXXX0000000
000XP111X000000X1111111X000000
000X11011X00000X11000111X00000
00X111111X0000X11111111X000000
00X110011X00000XX1111X00000000
00X110011XXXXXXXXXX11XXXXXXX00
00X1111111111111111111111111X0
000XXX11XXXXX11XXXXXXXXXXXXX00
000000XXXXXXXDDX00000000000000
00000X111111111XXXXXXXXX000000
00000X111111111111111111X00000
000000XXXX1111111E11XXXX000000
0000000000XXXXXXXXXX0000000000
000000000000000000000000000000