000000000000000000000000000
00P111100000000111111100000
000110110000000110001110000
001111110000001111111100000
001100110000000011110000000
001100110000000000110000000
001111111111111111111111111
000001100000110000000000000
000000000000110000000000000
000001111111110000000000000
000001111111111111111110000
000000000111111111100000000
000000000000000000000000000