000000000000000
0XXXXXXX0000000
0XP1111X0XXXX00
0X111X1X0X11X00
0X111X1X0X11X00
0XXXXX1XXXDDXX0
0X11111111111X0
0X11111111111X0
0X11111111111X0
0X11111111111X0
0X11111111111X0
0XXXXXXXXXXXXX0
000000000000000
000000000000000
000000000000000